0000000000000000000001010000010001000000000000100000000000000000001010010000000010000000000000100000
0000001000000100000000000000000000001000000000001000000001001100001000100000010000000001000001000000
1010000001001000000000100000010100000000000011000101000100101000000000010010000010000010000010000001
0001000000000100000000000000000000010000000000010001000000000000000000001110001000000100000000100000
1001000000000000000000000000100010000000000000000000100000000100000000100000000010100000100000000000
1000000000000010000000000000000110000000000100000000000000001000000100100000000000101010010001010000
0000001010000010001000100010000000010000010000000000000000000000000000110000100000100000001000000100
0000000000000001001000100000000000100000000000100010000000000000000000000100000001000000001000010000
0101000000001000000000000001100000000010000000000000000000010000000000000000100000000000001101000000
0001010000000000000010011000110010000100010010000000000111000011000010000000000000100000000000001000
0000010001010001001000001000000000000000000000000001000010000011000010000000010100000000100000010001
1000000000000000001000010000000001000000000000000000010000001100010000000000010001000000000000000001
0100000110000110110000000110110000000000100000000000101000000000000000000100100000000000000000000000
0101010000010001000000000001001000000000000010000000000010000000000100000110000000000110000101000100
0001010010011000010000000101000100000000110000100000010000000010000001000000000110010010000000010101
0000010000000000000000010000000000000000000000000000000000000001000000001011000000101000000000000000
0000000000000010001000000000000101100000000000001000100000000000010000000000000100000000000000000000
0000000000000000000000000000000110100000000010000100001000000000000000010000100000000000000000000000
0000000000000000100000010000000000000000000000000000000010100010000000000100000000000000100100001000
0000010000000000000011010000100000000000000101000000000001000100000000000000000000000000010010000000
0101000000000100000001000000000001000000000010001001000000100000000000010000000101000010000000000000
0001000010000000010000000010000000000000000000000100001000000000000000000000000000010001000010010000
0010000000000000000000010001010000100010000000000000000010000000110000000000000000000000001000000000
1010001001000000001100101010000000000000000000000100000000000010000000000010000000000000000000000010
0000011010000000000000100100100000100001001101000000100000001010100000010000000000001000000000011000
0000000000100000000000011100000000100000001000000100000001000000000000000001100100001100010100000000
0100000000110010000111000000000000010000000000001000000010000101001000000000010100100100000000000010
0000000000000100000000000000000000000000000000000000110011000110000000100010000000010010000000000010
0000110000010000000000101000000000000000000100001000000000010110001011000001100000100001000101000100
1000000000100000000010000010000000000000000010100100000000000100000000000010000010010000000100000001
0000100000000000010001001000000000000000000000000001010010000000000000000110000000100100100010100100
0000000000001000000011010000001100010110000000000100010000000000100000000000000000000010000000000000
0000000000001000000001000000000001001000000100100110001000000001011100000100000100000000000000000010
0000000000001000100000000100000000011100000000000000010100010000000010001100010001000001000000000000
0010100000000010100001000000001010010000000000000100000101100000100000000000000000110000001000000000
0000001000010000000100010000001000000000000000000000000000000010000001011000000000000000000000000001
0000001000001000000000000010000000100000000000000100000000010000010100000000100000001000000000000010
0100000001000000000000100010000001100000000000000000000100010000000000100101000001100101010000000000
0100001000000000010000010010000101000000101000000001000000000000001100000001100001000000000000000000
0000000010000000000101001000100001000000000000000000011010000000000000000001000000010000000000000000
0001000000000000000000000100100000100010010000100001000000000000100000000001000010000110000000000000
0000111001000000000001000000000100000100000000000000001000010100000000001001000000000000000000000000
0000000000000001000000010000000000001000100000000001000001000010000000000000000000000000000011000100
0000001000000010000000011000000000001000001010010000000010000000100000000000000001100000000000000000
0000000000000000000000100100000001011100000000100000000110000000000010000000000000000101000100000000
0000000000001100000000100000000000001100100010000100000000001101000001000000000000000000100100000100
0000001000001000000000000010000100000000001000010000000001000001000000000000110001000000010000000000
0000100000000000010010001000100000000000000011100010001000001000000000000010000010001000000000000000
1000000000001110100000110100010010001000000000000010000000000001000000001000000000000000000010000000
0100010000000000000000000100010000010011000000010001000000000000000000000000000001000000010000001000
0000100001000001000000000100010100000000000000000000100000001010001000000011000000010001000001001000
0001110001001000000100000000001000000010000000000000000000100001010000000010001000000000000000000101
0000010001000100000100000000001000000100001000000000000000000000000000100001000001000001000000000101
0000000000000001010010000000000000001000000000000000100010001101000000000100000011000000010000010010
0100000010000000000000000001110000000000010000010000000000000110010000000000000000000000000000001001
0100010000000000010001000000010000000100011001000000000000000011000000000000001010000000000001010000
0001010000000000000000000010000000001000000000000000000000000000000000001000000000000001000000000000
0000000100000000000100000000000000010000010000110101000000000100100100000000000000100000001000000100
0000100000000000000000000000000010000000000000000001001000000000001010000010000000000000100000010100
1000000000000000001000000100001000000000000110000000000000100010000000000000000001000000000000000001
0001000000000001000110000000000001000001000010000001100000010000100001000000000001000000001100000001
0000010000000000000000010000000001000000000000000000100101100010000001000000000000011000000001000000
0000000001000000000010000100000100000000000000000010000000000000100000000010001000000000000000111000
0100000010000000000100000000000000000001010100000000000000000000000001000100010000000000000000000000
0000001000000001000100000001001010000000000000001000001000000000100100000000001000000000010000000000
0010010000000101010000000000000100000001010000000000000000100000000000000000000000000000101000000100
0100000010000000000000000000100000001000000010000000000000000000000000001100000010000000011000000000
0010000000100000000000000000010001000000000000000001100000000000000100001000100000100000000000000000
0000000000001000010010000000000000000000001000000000101010000000000000000000000000000000000000010000
0001010000000000000000100000000000000000010000100000000000011000010000100010000000100100001000000000
0000000000000000000000000000000010000010000000000000010000100000001100000000000101110000000000000000
0000100000101000010000000000000000000000000100000101010100001000000001010000000011000000100000000000
0000000000000000000000000000110000011000101010000000001000010000100000000010000000000001001010111010
0100000000100000000000000000000010000000010000100000000100000000000000001100010000000001000000100000
0000000010000000000000100010001000001010000000000001000001100000100100000000001000010000100000010001
0000000000000000100100000000000000000100000100000100100010000000000000000100000000000000001010000100
0000000000010000000000000000000000000000010000001000010010001010000010100000000000001000000000100000
0010101000000000000001000000001010110000010000000000001000000000000000000000001010000000000000000000
0001000000010000000100000000001000100000000000001000100111001000000000010000000000100000000010000100
0000000000000000000010000000000000000000100000000000001000001001001000000000000000000000000110001000
0000000000010001010000100000000001000000000001010100000000000000000000010000000000001000010000010010
0100010000000000000000001000000100010000000100000100000000010010000000000010000000000001000101000000
0000001010000000000000000001000000000010101000010000000000010000000010000100000000100011000000000000
0000001000001000000000001000000001000000000000000000001010000000000001000000000000110000000000100000
0000010010000000100100010000000110010000000000100000100001000000000010000000010000000001000000000000
0000000101000010000000000000001000001000000000000000100001000000101100100101000010000000000101001000
0001000000000000000100000010000000100000000000000001000000000000000000100000000000000000000000000000
0100000100000000010000100000000001000100000000001000010000110000000110000000001000001001000100001000
0000001010000000001000001100000000000000010000000000100000000101101000100001000010000100000000000000
0000010000100100010000000010001110000000000000001100011000000010000000000000110000110000010000000000
0000000000001000000000000000000101000000000000000010000000000000000000100010110000001000000010000010
1000000000000001000010000000000010000100010000000001000000000110010000001000000000000000001000000000
0010001010001000000001011001000000001000000100001001100000000000100100000000000010000100000000011000
0000000000000000000010100000100000000000000000000010100000000000000001000100100010000000000000001000
0000000000001000000000000101010100010000000000000000001000000010000000000011010000000000000010000100
0000100000000000010000000000000000010000000001000010000000000000001001000000001000000000110010000000
0000010100000010000100010000100000000011000000000000000000000100000000001000000000000001000010000000
0000000000000001100000001100001000000000000000010000010010000000000010000000000100100000110101101100
0000000000000010000000100000010000000000000010000000100011000001100010001000100000000000000000000000
0010110000000000000000000000010010100010001011000000010010000001000000000000010000000000000001000100
